



NO ./path_to_the_north_texture

SO ./path_to_the_south_texture

WE ./path_to_the_west_texture

EA ./path_to_the_east_texture

C 220,100,0

F 225,30,1




 
11111111111111111111111111111111111
10000000000000000000011
111011111111111111111111111111111111
1110101 101111010001
1110111110111111111111111111111111
10000000000000000000111111111111                    11111111
111111111011000011100000000100001                   10000001
1000000000110000011101111111111111                  11111111
111101111111110111000000100000000011
11110111111111011101010010001111111
110000001101010111000000100011111
1000000000000E0011000000100011
100000000000000011010100100011
110000011101010111110111100011111111
11110111 111010110111101000111111
111111111 111111111111111111111111
 
1111111111111111111111111111111111
1000000000110000011101111111111111                  11111111
111101111111110111000000100011
11110111111111011101010010001111111
110000001101010111000000100011111
100000000000000011000000100011
100000000000000011010100100011
110000011101010111110111100011111111
11110111 111010110111101000111111
111111111 111111111111111111111111
