



NO ./path_to_the_north_texture

SO ./path_to_the_south_texture

WE ./path_to_the_west_texture

EA ./path_to_the_east_texture

C 255,100,1

F 225,30,1


111111111111111111111111111
100000000000000000000000001
10000000000S00000000000001
100000000000000000000000001
111111111110111111111111111
111111111110111111111111111
100000000000000000000000001
111111111111111111111111111