



NO ./path_to_the_north_texture

SO ./path_to_the_south_texture

WE ./path_to_the_west_texture

EA ./path_to_the_east_texture

C 255,100,1

F 225,30,1






1111111
1000001
10000W1
1000001 W N S E
11111111

1111111
1000001
1111111
