 ./path_to_the_north_texture
 ./path_to_the_south_texture
 ./path_to_the_west_texture
 ./path_to_the_east_texture
 220,100,0
 225,30,0
1
100000000011000001110111111111111
1000000000000000000001
1111111111111111111111111
1110101 101111010001
1111111 011111111111
100000000000000000001    
11111111101100001110000000000001
100000000011000001110111111111111         
11110111111111011100000010001    
11110111111111011101010010001
11000000110101011100000010001
1000000000000E001100000010001
1
10000000000000001101010010001
       
1100000111010101111101111000111
11110111 1110101 101111010001
11111111 1111111 111111111111
1
1
1
1
1
1
1
111111
1
1
1
1
111111
1
1
1
1
