NO images/wall.png

SO images/tile.png

WE images/sakamoto.png

EA images/spongebob.png

C 52,110,215

F 140,255,152

1111111111111111111
1000000000000000001
1000000000000000001
1000000000000000001
10000000N0000000001
1000000000000000001
1000000000000000001
1000000000000000001
1000000000000000001
1010000100000000101
1000000000000000001
1111111111111111111