1111111111111111111111111111111111111111111111111111111111111111
1000000000000001000000000000001000000000000001000000000000000001
1011111111111101011111111111101011111111111101011111111111111011
1000001000000101000001000000101000001000000101000001000000000001
1111111111111011111111111111011111111111111011111111111111111111
1000000000000001000000000000001000000000000001000000000000000001
1010000000001011010100000000011010100000000011010100000000000011
1111111100111111111111111111111111111111111111111111111111111111
1000001000100010000100000000010100001000000001010000100000000101
1011111111001110100111100111111100111100111111100111100111111111
1000000000000001000000000000001000000000000001000000000000000001
1111111111111101111111111111011111111111111011111111111111011111
1000000000000010000000000000010000000000000010000000000000010001
1011101011101001011101010111001011101010111001011101010111000011
1111000011110000111100111000111110001110000111110001110000111111
1000000000000010000000000000010000000000000010000000000000000001
1011111111111111011111111111111011111111111111011111111111111101
1000000000000001000000000000001000000000000001000000000000000001
1111111111111110111111111111101111111111111101111111111111111111
1000001000100010000100000000010100001000000001010000100000000101
1011111111001110100111100111111100111100111111100111100111111111
1000000000000001000000000000001000000000000001000000000000000001
1111111111111101111111111111011111111111111011111111111111011111
1000000000000010000000000000010000000000000010000000000000010001
1011101011101001011101010111001011101010111001011101010111000011
1111000011110000111100111000111110001110000111110001110000111111
100000000000001000000000000001000000000000001000000000000E000001
1011111111111111011111111111111011111111111111011111111111111101
1000000000000001000000000000001000000000000001000000000000000001
1111111111111110111111111111101111111111111101111111111111111111
1000000000000001000000000000001000000000000001000000000000000001
1111111111111111111111111111111111111111111111111111111111111111