NO images/wall.png

SO images/wall.png

WE images/wall.png

EA images/wall.png

C 52,110,215

F 140,255,152

1111111111111111111
1000000000000000001
1011111111111111011
1000001000000000001
1111111111111111111
1000000000000000001
1010100000000000011
111111111111N111111
1010000100000000101
1000000000000000001
1111111111111111111