11111111111111111111111111111111111111111111111111
10000000000000000000000000000000000000000000000001
10111111111111110000001111111111111111111111111001
10000000000000100000001000000000000000000000001001
10111111011110101111101011111101111111111110111001
10000001000000000000100000000010000000000010001001
10111111111111111110111111111110111111111111111001
10000000000000000000000000000000000000000000000001
10111111111111111111111111111111111111111111111001
10000000000000000000000000000000000000000000000001
1011111111111111111E111111111111111111111111111001
10000000000000000000000000000000000000000000000001
10111111111111111111111111111111111111111111111001
10000000000000000000000000000000000000000000000001
10111111111111111111111111111111111111111111111001
1000000000000000000000000000000000000000000000N001
11111111111111111111111111111111111111111111111111
10000000000000000000000000000000000000000000000001
10000000000000000000000000000000000000000000000001
11111111111111111111111111111111111111111111111111