111111111111111
100000000000101
1000P0100000011
111100000010101
100000000010101
100000E01111101
100000000000001
100000000000001
111111000111111
100000000000001
111111111111111